1111111111
1E01001011
1C00100001
111P100001
1000000111
1000C1C001
1111101111
1111111111
