11111111111111111111111111111111111111111111111111
10000E00100001000000000000000000000000000000000001
11101000100001000000000000000000000000000000000001
10001111100111001111100100111111100111111111111001
1000000000C001001000100100100000100100000000001001
10000000000001001000100100100000100100000000001001
11110011111111001000100100111110100100000000011001
10010010001001001000100000000000100111111110001001
10010010001001111000100000000000100000000010001001
10000000000000000000111111111111100000000010001111
10000000000000000000100000000000000100000000001001
11111111111111000000100000000000000100000000001001
10000000000001001111111111001111111100111111111001
10000000000001001000000000001000000100000000000001
11110011111111001000000000001000000100000000000001
10010010000010001111111111111111100000111111111001
10010010000010000000000000000000000000100000001001
10010011110010000000000100000000000111100000001001
10010000000011111111111C10011111111100000000001001
100100000000000000000CC000000000000100000000001001
100111111000000000C0000000000000000100000000001001
10000000100111111111111111111111111100000000001001
1000000010000000000000C000000000000100001111111001
10000000100000000000000000000000000100000000000001
10000000100000000001111001001001000100000000000001
10011111100100111111001001001001000100000011111001
10010000000100100000001111001001100111111110001001
1000000000010010C000000000001000000000000000001001
1P000000000100100000000000001000000000000000001001
11111111111111111111111111111111111111111111111111