1111111111111111111
1P00000000000000001
1011000000000001101
101C00001010000C101
1000100010100010001
100000000N000000001
1000010000000100001
1000000000000000001
1001100010100011001
10000N000E000N00001
1001100010100011001
1000000000000000001
1000010000000100001
100000000N000000001
1000100010100010001
101C00001010000C101
1011000000000001101
1000000000000000001
1111111111111111111