1111111111
1C00001C11
1111101011
111P0000C1
1111011111
10C00C00E1
1111111111